你不覺得她很正嗎	a
她身材好好喔	a
你看她的腿好細喔	a
你看她的胸部好大喔	a
那個女生好賢慧喔	a
剛剛那個女生身上好香喔	a
你不覺得她很有氣質嗎	a
她長得好可愛噢	a
她的聲音好甜喔	a
那女生完全就是你的菜呀	a
她的皮膚看起來好好喔	a
你不覺得她的眼睛很美嗎	a
她的睫毛好長喔	a
她拍照好上相喔	a
你不覺得他很會穿衣服嗎	a
她的髮型好好看喔	a
你不覺得她的身材比例很好嗎	a
她的手指好細長喔	a
"她真的很漂亮, 對不對"	a
聽說他很會做菜耶	a
你看那個女生腿真的超長耶	a
那女生也太辣了吧	a
你不覺得那女生真的很敢穿嗎超猛的	a
那女生裙子超短！！	a
你不覺得她臉真的很小嗎好羨慕	a
她超可愛的	a
她聲音超甜超嗲男生根本受不了啊	a
我是不是太愛亂花錢了	e
我是不是金錢觀念很差	e
你是不是沒那麼愛我	c
我是不是吵到你了	c
你會不會覺得我很煩	c
我會不會管太多了	c
我是不是太黏你了	c
我是不是很嘮叨	c
我是不是很不獨立啊	d
我是不是有點公主病	d
你會不會覺得我很沒有女人味	b
我覺得我不適合穿洋裝	b
你會覺得我很任性嗎	b
我的品味是不是很差	b
我的腰好像有點粗	b
我是不是變胖了	b
我是不是很粗魯	b
你不覺得我很沒氣質嗎	b
你會不會覺得我皮膚很差	b
我的臉會不會很大	b
我是不是需要整形	b
怎麼辦我好胖喔	b
你會不會覺得我太矮	b
我好像脾氣越來越差了	b
我是不是化妝前後差很多	b
我穿這裙子好看嗎	f
見你朋友穿這樣可以嗎？	f
這條是不是讓我看起來腿超細！！	f
今天的妝可以嗎？	f
露腿可以嗎？	f
短髮好看嗎！	f
這樣是不是讓臉看起來比較小！！	f
這件跟那件哪一件比較好	h
你覺得這上衣配這項鍊搭嗎	h
你覺得穿褲子還是裙子？	h
穿長裙好還是短裙？	h
深色好看還是淺色好！	h
我眼妝會不會太濃	g
染這個顏色好看還是之前的好看！	g
衣服緊會不會顯胖？	g
這樣穿會不會太露	g
你有沒有覺得我頭髮怪怪的	g
怎麼辦會不會覺得這件讓手臂看起來有點壯	g
最近覺得我長好醜怎麼辦:(	g
臉好像太白了，會不會？	g
這腮紅會太紅嗎？	g
你上次是不是有說要跟誰聚餐呀	r
跟你聚餐的人有誰呀？	r
那些朋友我認識嗎？	r
跟你聚會的朋友都有女友了嗎	r
吃飯時誰跟你一桌呀?	r
這次是誰約的?	r
怎麼會突然想到要聚餐呀?	r
很久沒跟那些朋友見面了齁~	r
他們會帶女友一起去嗎？	r
見面都聊什麼呀?	r
很久沒跟他們聚會了嗎?	r
你們要去吃什麼好吃的嗎?	r
我們有吃過聚會那間餐廳嗎?	r
這次會有誰呀?	r
下次我們可以一起跟他們吃飯呀	r
他只有找你一起去喔？	s
他叫你陪她去喔？	s
今天玩地開心嗎？	r
你們那群最近好像很常聚吼？	r
咦你們上次上禮拜不是也有去吃飯?	r
你這幾天是不是都很晚回家啊	r
你昨天很晚才睡喔	r
那你今天下班之後要幹嘛？	r
那我們連假要出去玩嗎	r
那他還有再找你出去嗎？	s
那之後她找你還要再去嗎?	s
為什麼你其他朋友沒有一起去啊	s
還是我下禮拜跟你一起去啊？	s
不然下次找大家一起來啊	s
你還真大方啊	i
你人緣最好了	i
大家都超愛你的	i
沒有你該怎麼辦啊	i
你真的好棒喔	j
你真的好厲害喔	j
你真的好貼心喔	j
他應該覺得你人超好的吧	k
對啦工作比較重要	k
沒關係多陪陪你朋友	k
你朋友沒你不行耶	k
可以啊你可以去沒關係	k
好阿你的朋友比較重要	k
你對朋友最夠意思了	k
真的! 我沒事	l
我很開心壓	l
我自己一個人很OK的	l
"沒問題, 我自己也去其他地方"	l
"沒關係壓, 我可以自己一個等你回來"	l
沒事呀~ 怎麼這樣問?	l
很好呀~ 你去跟朋友聚會我很開心壓	l
很棒呀~ 你這樣做我很開心	l
你可以去呀~ 我覺得這是很好的事情	l
OK啦~ 我真的覺得這很正常	l
"完全沒問題, 我真的可以接受"	l
我真的覺得很棒壓	l
"不會介意壓, 我很大方的"	l
"我才不會吃醋勒, 我這麼開明"	l
"有什麼好嫉妒的, 我覺得很好呀"	l
"不會不好呀, 我完全同意"	l
我真的很替你感到開心	l
我真的沒事呀	l
"我沒在生氣, 真的!"	l
"有什麼氣好生的, 我很好呀"	l
"你想太多, 我才不會這麼小氣哩"	l
有差嗎	m
沒關係啊	m
算了	m
別管我	m
恩恩	n
喔是喔	n
看你	o
都一樣	o
去啊	o
沒差	o
都好	o
隨便啊/隨你	o
都可以	o
你覺得我跟她誰比較漂亮	p
你覺得我比較可愛還是她比較可愛	p
你會不會覺得她個性比較好	p
他長得比我正多了	p
她身材是不是比我好	p
她皮膚好像比我好很多，對不對	p
我是不是個性跟她差很多	q
我是不是比不上前女友	q
你是不是覺得我個性很差跟你前女友不一樣	q
你會覺得你們兩個比我們適合嗎	q
你不覺得你們兩個感覺比較搭嗎	q
我覺得我好像比不上她，會嗎？	q
我是不是跟她沒辦法比？	q
你比較喜歡她，對不對	q
